Plumbing	SPECIALIZATION
Toilet Maintenance	SERVICE
Toilet Installation	SKILL
Toilet Repair	SKILL
Leak Fixing	SKILL
Toilet Unclogging	SKILL
Flushing System Repair	SKILL
Toilet Replacement	SKILL

Sink and Faucet Maintenance	SERVICE
Faucet Installation	SKILL
Faucet Repair	SKILL
Sink Installation 	SKILL
Sink Repair	SKILL
Leak Fixing	SKILL
Faucet Replacement	SKILL
Sink Replacement	SKILL

Drain Unclogging	SERVICE
Drain Cleaning	SKILL
Drain Snaking	SKILL
Hydro Jetting	SKILL
Clog Removal	SKILL
Pipe Inspection	SKILL

Shower Maintenance 	SERVICE
Showerhead Installation	SKILL
Showerhead Repair	SKILL
Leak Fixing	SKILL
Valve Replacement	SKILL
Shower pipe repair	SKILL

Bathtub Maintenance	SERVICE
Bathtub Installation	SKILL
Bathtub Repair	SKILL
Leak Fixing	SKILL
Drain Repair	SKILL
Fixture Replacement	SKILL
Caulking and Sealing	SKILL

Pipe Repair	SERVICE
Leak Detection	SKILL
Pipe Cutting	SKILL
Pipe Fitting	SKILL
Pipe Replacement	SKILL
Pipe Welding	SKILL
Joint Sealing	SKILL

Water Line Maintenance	SERVICE
Water Line Installation	SKILL
Pipe Fitting	SKILL
Pipe Connection 	SKILL
Water Line Repair	SKILL
Pressure Testing	SKILL

Water Heater Maintenance	SERVICE
Sediment Flushing	SKILL
Thermostat Adjustment	SKILL


Electrical	SPECIALIZATION
Lighting Maintenance	SERVICE
Incandescent Light Installation	SKILL
Fluorescent Light Installation	SKILL
LED Light Installation	SKILL
Bulb Replacement	SKILL
Light Fixture Installment	SKILL

Electrical Wiring and Rewiring	SERVICE
Wire Installation	SKILL
Conduit Installation 	SKILL
Electrical Insulation	SKILL
Circuit Connection	SKILL

Electrical Maintenance	SERVICE

Socket Maintenance	SERVICE
Socket Installation	SKILL
Socket Replacement	SKILL
Socket Tester	SKILL
Childproof Outlet Installation	SKILL
Copper Sweating	SKILL

Appliance Maintenance	SPECIALIZATION
Washing Machine Maintenance 	SERVICE
Washing Machine Repair	SKILL
Belt Replacement	SKILL
Leak Tracking	SKILL
Drum Cleaning	SKILL
Hose Replacement	SKILL

Television Maintenance	SERVICE
Screen Replacement	SKILL
Screen Repair	SKILL
Remote Sensor Repair	SKILL
Power Supply Board Repair	SKILL
Backlight Replacement	SKILL
Backlight Repair	SKILL

Electric Fan Maintenance	SERVICE
Motor Cleaning 	SKILL
Motor Lubrication	SKILL
Blade Replacement 	SKILL
Oscillation Mechanism Repair	SKILL
Speed Control Repair	SKILL
Bearing Replacement	SKILL

Refrigerator Maintenance	SERVICE	
Condenser Coil Cleaning	SKILL
Defrost System Maintenance	SKILL
Thermostat Control Check	SKILL
Ice Maker Repair	SKILL

Air Conditioner Maintenance	SERVICE
Air Conditioner Repair	SKILL
Air Conditioner Installation	SKILL
Coil Cleaning	SKILL
Filter Cleaning	SKILL
System Tune-up	SKILL

Furniture Maintenance	SPECIALIZATION
Sofa Maintenance	SERVICE
Cushion Repair	SKILL
Frame Reinforcement	SKILL
Upholstery Cleaning 	SKILL
Spring Replacement	SKILL
Cushion Replacement	SKILL

Bed Maintenance	SERVICE
Frame Tightening	SKILL
Slat Replacement	SKILL
Mattress Rotation	SKILL
Headboard Repair 	SKILL

Cabinet Maintenance	SERVICE
Lock Replacement	SKILL
Handle Replacement	SKILL
Cabinet Refacing	SKILL
Cabinet Repair	SKILL

Door Maintenance	SERVICE
Hinge Replacement	SKILL
Door Alignment	SKILL
Door Repair	SKILL
Weather Stripping Installation	SKILL
Sliding Track Repair	SKILL
Roller Repair	SKILL
Scratch Repair	SKILL
Dent Repair	SKILL
Automatic Door Mechanism	SKILL

House Keeping	SPECIALIZATION
General Cleaning	SERVICE
Sweeping Floors	SKILL
Mopping Floors	SKILL
Surface Wiping	SKILL
Vacuuming Carpet	SKILL
Organizing 	SKILL
Decluttering	SKILL

Deep Cleaning	SERVICE
Tile Scrubbing	SKILL
Steam Cleaning 	SKILL
Stain Removal 	SKILL
Upholstery Deep Cleaning	SKILL
Mattress Sanitizing	SKILL

Laundry	SERVICE
Clothes Sorting	SKILL
Hand Washing	SKILL
Hand Washing Delicates	SKILL
Ironing	SKILL


